XSXXXXXXXXXXXX
XOXXXXXXXXXXXX
XOXXXXXXXXXXXX
XOOOOOOOOOOOXX
XXXXXXXXXXXOXX
XXXXXXXXXXXOXX
XXXXXXXXXXXOXX
XXXXXXXXXXXOXX
XXXXXXXXXXXOXX
XXXXXXXXXXXOXX
XXXXXXXXXXXOXX
XXXXXXXXXXXOXX
XXXXXXXXXXXOXX
XXXXXXXXXXXEXX