OOOOXXXXOXXXXXX
OXOOOOOXOOOOOXX
OXXXXXOXOXXXOOO
MXOOOOOOOXXOOXX
XXXXOXXXXXXOXXX
XXXXOXXXXXXOXXX
XXXXOOXXXOOOXXX
XXOOOXXXXOXXXXX
XXOXXXXXOOOOXXX
XXOXXOOOOXXOXXX
XXOXXXXXOXXXXXX
XXOOXXXOOOOOXXX
XXXOXXXOXXXXXXX
XXXOXXXOOOOOOGX
XXXOXXXXXXXXXXX