OOOOXXXXOXXXXXX
OXOOOOOXOOOOOXX
MXXXXXOXOXXXOOO
OXOOOOOOOXXOOXX
XXXXOXXXXXXOXXX
XXXXOXXXXXXOXXX
XXXXOOXXXOOOXXX
XXOOOXXXXOXXXXX
XXOXXXXXOOOOXXX
XOOXXOOOOXXOXXX
XXOXXXXXOXXXXXX
XXOOXXXOOOOOXXX
XXXOXXXOXXXXXXX
XXXOOOXOOOOOOOG
XXXOXXXXXXXXXXX