OOOOXXXXOXXXXX
OXOOOOOXOOOOOX
OXXXXXOXOXXXOX
OXOOOOOOOXXOOX
XXXXOXXXXXXOXX
XXXXOXXXXXXOXX
XXXXOOXXXOOOXX
XXOOOXXXXOXXXX
XXOXXXXXOOOOXX
XXOXXOOOOXXOXX
XXOXXXXXOXXXXX
XXOOXXXOOOOOXX
XXXOXXXOXXXXXX
XXXOXXXOOOOOOG